#### 001 ####
犯人管理室{ffff}

#### 002 ####
通往犯人管理室的通道{ffff}

#### 003 ####
墓地{ffff}

#### 004 ####
警戒塔前方的广场{ffff}

#### 005 ####
监控室{ffff}

#### 006 ####
通往监狱的通道{ffff}

#### 007 ####
监狱集会室{ffff}

#### 008 ####
监狱起居室{ffff}

#### 009 ####
断头台前方的广场{ffff}

#### 010 ####
操作室{ffff}

#### 011 ####
铁桥{ffff}

#### 012 ####
医务室{ffff}

#### 013 ####
处决室{ffff}

#### 014 ####
通往拷问室的通道{ffff}

#### 015 ####
拷问室{ffff}

#### 016 ####
训练房{ffff}

#### 017 ####
通往医疗大厦的通道{ffff}

