#### 001 ####
等候室{ffff}

#### 002 ####
传送机车站{ffff}

#### 003 ####
货物堆积室{ffff}

#### 004 ####
潜水艇停泊所{ffff}

#### 005 ####
机场电梯{ffff}

#### 006 ####
潜水艇内部{ffff}

