#### 001 ####
公馆前院{ffff}

#### 002 ####
{ffff}

#### 003 ####
公馆大厅{ffff}

#### 004 ####
盥洗室{ffff}

#### 005 ####
肖像画之间的空隙{ffff}

#### 006 ####
放映室{ffff}

#### 007 ####
会议室{ffff}

#### 008 ####
会议室外面的走廊{ffff}

#### 009 ####
秘书室{ffff}

#### 010 ####
办公室{ffff}

#### 011 ####
石桥{ffff}

#### 012 ####
休闲活动室{ffff}

#### 013 ####
连接通道{ffff}

#### 014 ####
公馆停船所{ffff}

#### 015 ####
潜水艇内部{ffff}

